5 5 6 0 0 0 0 0 0 0 0 0 0 0 9 8
6 5 6 0 0 2 2 0 0 0 0 0 0 0 9 8
6 0 6 0 0 2 2 0 0 0 0 0 0 0 10 8
6 0 6 0 2 2 2 2 0 0 0 0 0 0 11 8
0 0 0 0 2 2 2 2 0 0 0 0 0 0 0 0
0 0 0 0 2 2 2 2 0 0 0 0 0 0 0 0
0 0 0 0 0 0 0 0 0 0 0 0 0 0 0 0
0 0 0 0 0 0 0 0 0 0 0 0 0 0 0 0
0 0 0 0 0 0 0 0 0 0 0 0 0 0 0 0
0 0 0 0 0 0 0 1 1 0 0 0 0 0 0 0
0 0 0 0 0 0 0 1 1 0 0 0 0 0 0 0
0 0 0 0 0 0 0 1 1 0 0 0 0 0 0 0